{
	"width": 126,
	"height": 64,
	"spawn": [15, 30],
	"flags": ["Build"],
	"places": {
		"stairdown": [37, 33],
		"caveentrance": [31, 50],
		"bridge": [96, 1],
		"cavebridge": [1, 60]
	},
	"field": [
	
	
	
	
	
	
	
		",,,,,,,,,,,,,,,,,,,,,,,,,,,~~~~~~~~~~~~~~~~~~~~~~~~~~~~~~~~~~~~~~~~~~~~~~~~~~~~~~~~~~~~~~~~~~~~333~~~~~~~~~~~~~~~~~~~~~~~~~~~~",
		",,,,,,,,,,,,,,,,,~~~~~~~~~~~~~~~~~~~~~~~~~~~~~~~~~~~~~~~~~~~~~~~~~~~~~~~~~~~~~~~~~~~~~~~~~~~~~~===~~~~~~~~~~~~~~~~~~~~~~~~~~~~",
		",,,,,,,,,,,,~~~~~~~~~~~~~~~~~~~~~~~~~~~~~~~~~~~~~~~~~~~~~~~~~~~~~~~~~~~~~~~~~~~~~~~~~~~~~~~~~~~===~~~~~~~~~~~~~~~~~~~~~~~~~~~~",
		",,,,,,,,~~~~~~~~~~~~~~~~~~~~~~~~~~~~~~~~~~~,,,,,,,,,,,,,,,,,,,,,,,,,,,,,,,,,,,,,,,,,,,,,,,,,,,'...',,,,,,,,,,,,,,,,,,,,,,~~~~~",
		",,,,,,~~~~~~~~~~~~~~~~~~~~~~~~,,,,,,*,,,,,,,,,,,,,,,,,,,,,,,,,,,,,,,,,,,,,,,,,,,,,,,,,,,,,,,,,'...',,,,,,,,,,,,,,,,,,,,,,~~~~~",
		",,,,~~~~~~~~~~~~~~~,,,,,,,,,,,,,,,,,,,,,,,,,,,,T,,,,,,,,,,,,,,,,,,,,,,,,,,,,,,,,,,,,,,,,,,,,,,''.'',,,,,,,,,,,,,,,,,,,,,,~~~~~",
		",,,~~~~~~~~~~~,,,,,,,,,,,,,,,,,,,,,,,,,T,,,,,,,,,,,,,,,,,,,,,,,,,,,,,,,,,,,,,,,,,,,,,,,,,,,,,,''.'',,,,,,,,,,,,,,,,,,,,,,~~~~~",
		",,~~~~~~~~~,,,,,,,,,,,,,,,,,,,,,,,,,,,,,,,,,,,,,,,,,,,,,,,,,,,,,,,,,,,,,,,,,,,,,,,,,,,,,,,,,,,''.'',,,,,,,,,,,,,,,,,,,,,,~~~~~",
		",,~~~~~~,,,,,,,,,,,,,,,,,,,,,,,,,,,,,,,,,,,T,,,,,,T,,,,,,,,,,,,,,,,,,,,,,,,,,,,,,,,,,,,,,,,,,,,'.',,,,,,,,,,,,,,,,,,,,,,,~~~~~",
		",~~~~~~,,,,,,,,,,,,,,,,,,,,,,,,,,,,,,,,,,,,,,,,,,,,,,,,,,,,,,,'',,,,,,,,,,,,,,,,,,,,,,,,,,,,,,,'.',,,,,,,,,,,,,,,,,,,,,,,~~~~~",
		",~~~~~,,,,,,,,,''''''''T'''''''''''''''''''''''T'''''''''''''''',,,,,,,,,,,,,,,,,,,,,,,,,,,,,,,'.',,,,,,,,,,,,,,,,,,,,,,,~~~~~",
		"~~~~~~,,,,,,,'''''''''''''T''''''''''''''''''''''''''''''''''''',,,,,,,,,,,,,,,,,,,,,,,,,,,,,,,'.',,,,,,,,,,,,,,,,,,,,,,,~~~~~",
		"~~~~~*'''T''''...................................................................................',,,,,,,,,,,,,,,,,,,,,,,~~~~~",
		"~~~~~.'''''''.'''''''''''''''''''''''''''''''''''''''''''''''''',,,,,,,,,,,,,,,,,,,,,,,,,,,,,,,,,,,,,,,,,,,,,,,,,,,,,,,,,~~~~~",
		"~~~~~........''''''''''''''''''''''''''''''''''''''''''''''''''',,,,,,,,,,,,,,,,,,,,,,,,,,,,,,,,,,,,,,,,,,,,,,,,,,,,,,,,,~~~~~",
		"~~~~~.'''...'''',,,,,,,,,,,,,,,,,,,,,,,,,,'''''''',,,,,,,,,,,,'',,,,,,,,,,,,,,,,,,,,,,,,,,,,,,,,,,,,,,,,,,,,,,,,,,,,,,,,,~~~~~",
		"~~~~~''''...'''',,,,,,,,,,,,,,,,,,,,,,,,,,'''''''',T,,,,,,,,,,'',,,,,,,,,,,,,,,,,,,,,,,,,,,,,,,,,,,,,,,,,,,,,,,,,,,,,,,,,~~~~~",
		"~~~~~'''''..'''',,,,,,,,,,,,,,,,,,,,,,,,,,'''''''',,,,,,,,,,,,'',,,,,,,,,,,,,,,,,,,,,,,,,,,,,,,,,,,,,,,,,,,,,,,,,,,,,,,,,~~~~~",
		",~~~~'''''..'''',,,,,,,,,,,,,,,,,,,,,,,,,,'''''''',,,,,,,,,,,,'',,,,,,,,,,,,,,,,,,,,,,,,,,,,,,,,,,,,,,,,,,,,,,,,,,,,,,,,,~~~~~",
		",~~~~''''''.'''',,,,,,,,,,,,,,,,,,,,,,,,T,'''''''',,,,,,,,,,,,'',,,,,,,,,,,,,,,,,,,,,,,,,,,,,,,,,,,,,,,,,,,,,,,,,,,,,,,,,~~~~~",
		",~~~~~,,,,..'''',,,,,,,,,,,,,,,,,,T,,,,,,,'''''''',,,,,,,,,,,,'',,,,,,,,,,,,,,,,,,,,,,,,,,,,,,,,,,,,,,,,,,,,,,,,,,,,,,,,,~~~~~",
		",~~~~~,,,,'..''',,,,,,,,,,,,,,,,,,,,,,,,,,'''''''',,,,,,,,,,,,'',,,,,,,,,,,,,,,,,,,,,,,,,,,,,,,,,,,,,,,,,,,,,,,,,,,,,,,,,~~~~~",
		",~~~~~,,,,''.''',,,,,,,,,,,,,,,,,,,,,,,,,,'''''''',,,,,,,,,,,,'',,,,,,,,,,,,,,,,,,,,,,,,,,,,,,,,,,,,,,,,,,,,,,,,,,,,,,,,,~~~~~",
		",~~~~~,,,,,'..'',,,,,,,,,,,,,,,,,,,,,,,,,,'''''''',,,,,,,,,,,,'',,,,,,,,,,,,,,,,,,,,,,,,,,,,,,,,,,,,,,,,,,,,,,,,,,,,,,,,,~~~~~",
		",~~~~~,,,,,''.'',,,,,,,,,,,,,,,,,,,,,,,,,,'''T'''',,,,,,,,,,,,'',,,,,,,,,,,,,,,,,,,,,,,,,,,,,,,,,,,,,,,,,,,,,,,,,,,,,,,,,~~~~~",
		",~~~~~,,,,,'..''''''#####################''''''''',,,,,,,,,,,,'',,,,,,,,,,,,,,,,,,,,,,,,,,,,,,,,,,,,,,,,,,,,,,,,,,,,,,,,,~~~~~",
		",~~~~~,,,,,''..'''''#+++++++++++++#+++++#''''''''',,,,,,,,,,,,'',,,,,,,,,,,,,,,,,,,,,,,,,,,,,,,,,,,,,,,,,,,,,,,,,,,,,,,,,~~~~~",
		",~~~~~'''''''..'''.'#+++++++++++++#+++++#''''''''',,,,,,,,,,,,'',,,,,,,,,,,,,,,,,,,,,,,,,,,,,,,,,,,,,,,,,,,,,,,,,,,,,,,,,~~~~~",
		"~~~~~''''''''''..'''#+++++++++++++++++++#''''''''',,,,,,,,,,,,'',,,,,,,,,,,,,,,,,,,,,,,,,,,,,,,,,,,,,,,,,,,,,,,,,,,,,,,,,~~~~~",
		"~~~~~''''''''.'.''..D+++++++++++++#+++++#''''''''',,,,,,,,,,,,'',,,,,,,,,,,,,,,,,,,,,,,,,,,,,,,,,,,,,,,,,,,,,,,,,,,,,,,,,~~~~~",
		"~~~~~'''''..''.'....D+++++++++++++#######''''''''',,,,,,,,,,,,'',,,,,,,,,,,,,,,,,,,,,,,,,,,,,,,,,,,,,,,,,,,,,,,,,,,,,,,,,~~~~~",
		"~~~~~''''''.'..'....#+++++++++++++#+++++#''''''''',,,,,,,,,,,,'',,,,,,,,,,,,,,,,,,,,,,,,,,,,,,,,,,,,,,,,,,,,,,,,,,,,,,,,,~~~~~",
		"~~~~,,,,,,'.'#d.....#+++++++++++++#+++++#''''''''',,,,,,,,,,,,'',,,,,,,,,,,,,,,,,,,,,,,,,,,,,,,,,,,,,,,,,,,,,,,,,,,,,,,,,~~~~~",
		"~~~~,,,,,,'.'#..d..^#+++++++++++++++++>+#''''''''',,,,,,,,,,,,'',,,,,,,,,,,,,,,,,,,,,,,,,,,,,,,,,,,,,,,,,,,,,,,,,,,,,,,,,~~~~~",
		"~~~~,,,,,,'.'########+++++++++++++#+++++#''''''''',,,,,,,,,,,,'',,,,,,,,,,,,,,,,,,,,,,,,,,,,,,,,,,,,,,,,,,,,,,,,,,,,,,,,,~~~~~",
		"~~~~,,,,,,'.''''''''#####################''''''''',,,,,,,,,,,,'',,,,,,,,,,,,,,,,,,,,,,,,,,,,,,,,,,,,,,,,,,,,,,,,,,,,,,,,,~~~~~",
		"~~~~,,,,,,'.'''''''''''''''''''''''''''''''''''''',,,,,,,,,,,,'',,,,,,,,,,,,,,,,,,,,,,,,,,,,,,,,,,,,,,,,,,,,,,,,,,,,,,,,,~~~~~",
		"~~~~~,,,,,'.'''''''''''''''''''''''''''''''''''''',,,,,,,,,,,,'',,,,,,,,,,,,,,,,,,,,,,,,,,,,,,,,,,,,,,,,,,,,,,,,,,,,,,,,,~~~~~",
		"~~~~~,,,,,'.'''''''''''''''''''''''''''''''''''''''''''''''''''',,,,,,,,,,,,,,,,,,,,,,,,,,,,,,,,,,,,,,,,,,,,,,,,,,,,,,,,,~~~~~",
		"~~~~~~,,,,'....................................................................................,,,,,,,,,,,,,,,,,,,,,,,,,,~~~~~",
		",~~~~~,,,,'''T'''''''''''''''''''''''''''''''''''''''''''''''''',,,,,,,,,,,,,,,,,,,,,,,,,,,,,,,,,,,,,,,,,,,,,,,,,,,,,,,,,~~~~~",
		",~~~~~~''''''''''''''''''''''''''''''''''''''''''''''''''''''''',,,,,,,,,,,,,,,,,,,,,,,,,,,,,,,,,,,,,,,,,,,,,,,,,,,,,,,,,~~~~~",
		",~~~~~~''''''''',,,,,,,,,,,,,,,''.',,,,,,,,,',,,,,,,,,,,,,,,,,'',,,,,,,,,,,,,,,,,,,,,,,,,,,,,,,,,,,,,,,,,,,,,,,,,,,,,,,,,~~~~~",
		",,~~~~~'',,,,,,,,,,,,,,,,,,,,,,'''',,,,T,,,,',,,,,,,,,,,,,,,,,'',,,,,,,,,,,,,,,,,,,,,,,,,,,,,,,,,,,,,,,,,,,,,,,,,,,,,,,,,~~~~~",
		",,~~~~~'',,,,,,,,,,,,,,,,,,,,,,'.'',,,,,,,,,',,T,,,,r,,,r,,,,,'',,,,,,,,,,,,,,,,,,,,,,,,,,,,,,,,,,,,,,,,,,,,,,,,,,,,,,,,,~~~~~",
		",,~~~~~'',,,,,,,,,,,,,,,,,,,,,,T'.',,,,,,,,,',,,,,,,,,,,,,,,,,'',,,,,,,,,,,,,,,,,,,,,,,,,,,,,,,,,,,,,,,,,,,,,,,,,,,,,,,,,~~~~~",
		",,~~~~~'',,,,,T,,,,,,,,,,,,,,,,'''',T,,,,,T,',,,,,,T,,r,,,,,,,'',,,,,,,,,,,,,,,,,,,,,,,,,,,,,,,,,,,,,,,,,,,,,,,,,,,,,,,,,~~~~~",
		",,~~~~~'',,,,,,,,,,,,,,,,,T,,,,'''',,,,,,,,,',T,,,,,,,,,,,,,,,'',,,,,,,,,,,,,,,,,,,,,,,,,,,,,,,,,,,,,,,,,,,,,,,,,,,,,,,,,~~~~~",
		",,~~~~~'',,,,,,,,,,,,,,,,,,,,,,'T.',,,,,,,,T,,,,,,,r,,,,T,,,,,'',,,,,,,,,,,,,,,,,,,,,,,,,,,,,,,,,,,,,,,,,,,,,,,,,,,,,,,,,~~~~~",
		",,~~~~~'',,,,,,,,,,,,,,,,,,,,,,'''',,,T,,,,,,,,,,,,,,,,,,,,,,,'',,,,,,,,,,,,,,,,,,,,,,,,,,,,,,,,,,,,,,,,,,,,,,,,,,,,,,,,,~~~~~",
		",~~~~~~'',,,,,,,,,,,,XXXXXXXXXX'.'',,,,,,,,,,,,T,,,,,,,T,,,,,,'',,,,,,,,,,,,,,,,,,,,,,,,,,,,,,,,,,,,,,,,,,,,,,,,,,,,,,,,,~~~~~",
		",~~~~~~'',,,,,,XXXXXXX        XCX'',,,,,T,,,,,,,,,,,,,,,,,,,,,XX,,,,,,,,,,,,,,,,,,,,,,,,,,,,,,,,,,,,,,,,,,,,,,,,,,,,,,,,,~~~~~",
		",~~~~~'''',,XXXX              XXXXX,,,,,,,,,,,,T,,,,,,,,,,,,XXXXX,,,,,,,,,,,,,,,,,,,,,,,,,,,,,,,,,,,,,,,,,,,,,,,,,,,,,,,,~~~~~",
		",~~~~~''''XXX                     XXXX,,,,,,,,,,,,,,,,,,,,,XX   XXX,,,,,,,,,,,,,,,,,,,,,,,,,,,,,,,,,,,,,,,,,,,,,,,,,,,,,,~~~~~",
		"X~~~~~'''XX                          XXX,,,,,,,XX,,,,,,,,,,X      XX,,,,,,,,,,,,,,,,,,,,,,,,,,,,,,,,,,,,,,,,,,,,,,,,,,,,,~~~~~",
		"X~~~~~''XX                             XXX,,,XXXXXXX,,,,,,XX       X,,,,,,,,,,,,,,,,,,,,,,,,,,,,,,,,,,,,,,,,,,,XXXXX,,,,,~~~~~",
		"X~~~~~''X                                X,,XX     XXXX,,XX        XX,,,,,,,,,,,,,,,,,,,,,,,,,,,,,,,,,,,,,,,XXXX   XXX,,,,~~~~",
		"X~~~~~''X                                X,XX         XXXX          XXXX,,,XXX,,,,,,,,,,,,,,,,,,,,,,,,,,,,XXX        XXXXXX~~~",
		"X~~~~~'XX                                XXX                           XXXXX XX,,,,,,,,,,,,,,,,,,,,,,,,,,XXX              XX~~",
		"#~~~~~'XX                                                                     XX,,,,,,,,,,,,,,,,,,,,,,,XXX                 X~~",
		"2=====''X                                                                      XXXXXX,,,,,,,,,,,X,,,,,XX                   XX~",
		"#~~~~~XXX                                                                           XXXX,XXXXXXXXX,XXXX                     XX",
		"X~~~~~X                                                                                XXX       XXX                          ",
		"X~~~~~X                                                                                                                       "
	],
	"mapping": {
		",": ["grass"],
		"'": ["grass"],
		"T": ["grass", "tree"],
		"~": "water",
		"=": ["water", "bridge"],
		"*": ["ground", {
			":template": "spawner", "template": {":template": "pebble"}, "delay": 600, "initial_spawn": false
		}],
		"d": ["ground", {
			":template": "spawner", "template": {":template": "dummy"}, "delay": 600, "initial_spawn": true
		}],
		"D": ["ground", "opendoor"],
		"#": "wall",
		":": ["ground", {
			":template": "spawner", "template": {":template": "radishseed"}, "delay": 600, "initial_spawn": false
		}],
		".": "ground",
		"+": "floor",
		"X": "rock",
		"^": ["spiketrap", "ground"],
		">": [
			{":template": "portal", "destination": "basement", "destpos": "stairup"},
			{":template": "img", "sprite": "stairdown"},
			"floor"
		],
		"C": [
			{":template": "portal", "destination": "cave", "destpos": "stairup"},
			{":template": "img", "sprite": "stairdown"},
			"floor"
		],
		"r": ["grass", {":template": "singleton", "ent": {":template": "rabbit"}}],
		"3": [{":template": "portal", "destination": "smallview", "destpos": "begin"}, "bridge", "water"],
		"2": [{":template": "portal", "destination": "tutorial", "destpos": "tunnelout"}, "floor"],
		"E": ["grass", "trader"],
		" ": []
	}
}
