{
	"width": 42,
	"height": 23,
	"spawn": [5, 5],
	"field": [
		"     %%%                                  ",
		"XXXXX,.,XXXXXXXXXX~~~XXXXXXXXXXXXXXXXXXXXX",
		"XT,,,,.,,,,,T,,,,,~~~,,,,,,,,,,,,,,,,,,,,X",
		"X,,T,,.,,,,,,,T,,,~~~,,,,,,,,,,,,,,,,,,,,X",
		"X,,,,,.,,,T,,,,,,,~~~,,,,,,,,,,,,,,,,,,,,X",
		"X,,,,,,,,,,,T,,T,,~~~,,,,,,,,,,,,,,,,,,,,X",
		"X,,,,,.,,,,,,,,,,,~~~~,,,,,,,,,,,,,,,,,,,X",
		"X,,,T,.,T,,T,,,,,,~~~~~~~~~~~~~~~~~~~~~~~~",
		"X,,,,,.,,,,,T,,,,,~~~~~~~~~~~~~~~~~~~~~~~~",
		"X,,,T,.,,T,,,,,,,,~~~~~~~~~~~~~~~~~~~~~~~~",
		"X,,,,,.,,,,,,T,,,,,,,,T,,,,T,,,,TT,,,,,,,X",
		"X,,,T,.,,,T,,,,,,,T,,,,,,,,,,,,,,,,,,,T,,X",
		"X,T,,,.,,,,,,,T,,,,,,,T,,,,,,T,,,,T,,,,,,X",
		"X,,,,,,,,,,,T,,,,,,,T,,,,,,,,,,,,,,,,,T,,X",
		"X,T,,,,,,T,,,,T,,T,,,,,,,,T,,,,,T,,,,,,,,X",
		"X,,,T,,,,,,,,,,,,,,,,,,T,,,,,,T,,,,,,T,,,X",
		"X,,T,,,,,,,,T,,,T,,,,,,,,,,,,,,,,,T,,,,,,X",
		"X,,,,,,T,,,,,,,,,,,,,,,T,T,,,,,,,,,,,,,,TX",
		"X,,,T,,,,,,,,,,T,,,,,,,,,,,,,,,,T,,,,,,,,X",
		"X,T,,,,T,,,T,,,,,,,T,,,,,,,T,,,,,,,,,,,T,X",
		"X,T,,T,,,,,,,T,,,,,,,,,T,,,,,T,,,,,,,T,,,X",
		"X,,T,,,T,,,T,,,T,T,,,,,,,T,,,T,,,,,T,,,T,X",
		"XXXXXXXXXXXXXXXXXXXXXXXXXXXXXXXXXXXXXXXXXX"
	],
	"mapping": {
		"#": "wall",
		",": "grass",
		".": "ground",
		"~": "water",
		"b": "bridge",
		"+": "floor",
		"'": "greengrass",
		"T": ["grass", "tree"],
		"f": ["grass", "fence"],
		"X": "rock",
		"*": ["grass", "pebble"],
		"%": {"type": "portal", "kwargs": {"destination": "room"}},
		" ": []
	}
}
