{
	"width": 64,
	"height": 64,
	"spawn": [10, 10],
	"places": {
		"left": [1, 12],
		"bottomleft": [1, 39],
		"bridge": [34, 1]
	},
	"field": [
		
		
		
		
		
		
		
		
		
		" ~~~~~~~~~~~~~~~~~~~~~~~~~~~~~~~~%%%~~~~~~~~~~~~~~~~~~~~~~~~~~~~",
		" ~~~~~~~~~~~~~~~~~~~~~~~~~~~~~~~~===~~~~~~~~~~~~~~~~~~~~~~~~~~~~",
		" ~~~~~~~~~~~~~~~~~~~~~~~~~~~~~~~~===~~~~~~~~~~~~~~~~~~~~~~~~~~~~",
		"1',,,,,,,,,,,,,,,,,,,,,,,,,,,,,,'...',,,,,,,,,,,,,,,,,,,,,,~~~~~",
		"1',,,,,,,,,,,,,,,,,,,,,,,,,,,,,,''.'',,,,,,,,,,,,,,,,,,,,,,~~~~~",
		"1',,,,,,,,,,,,,,,,,,,,,,,,,,,,,,,'.',,,,,,,,,,,,,,,,,,,,,,,~~~~~",
		"1',,,,,,,,,,,,,,,,,,,,,,,,,,,,,,,'.',,,,,,,,,,,,,,,,,,,,,,,~~~~~",
		"1',,,,,,,,,,,,,,,,,,,,,,,,,,,,,,,'.',,,,,,,,,,,,,,,,,,,,,,,~~~~~",
		"1',,,,,,,,,,,,,,,,,,,,,,,,,,,,,,,'.',,,,,,,,,,,,,,,,,,,,,,,~~~~~",
		"1',,,,,,,,,,,,,,,,,,,,,,,,,,,,,,,'.',,,,,,,,,,,,,,,,,,,,,,,~~~~~",
		"1',,,,,,,,,,,,,,,,,,,,,,,,,,,,,,,'.',,,,,,,,,,,,,,,,,,,,,,,~~~~~",
		"1'''''''''''''''''''''''''''''''''.',,,,,,,,,,,,,,,,,,,,,,,~~~~~",
		"1..................................',,,,,,,,,,,,,,,,,,,,,,,~~~~~",
		"1''''''''''''''''''''''''''''''''''',,,,,,,,,,,,,,,,,,,,,,,~~~~~",
		"1',,,,,,,,,,,,,,,,,,,,,,,,,,,,,,,,,,,,,,,,,,,,,,,,,,,,,,,,,~~~~~",
		"1',,,,,,,,,,,,,,,,,,,,,,,,,,,,,,,,,,,,,,,,,,,,,,,,,,,,,,,,,~~~~~",
		"1',,,,,,,,,,,,,,,,,,,,,,,,,,,,,,,,,,,,,,,,,,,,,,,,,,,,,,,,,~~~~~",
		"1',,,,,,,,,,,,,,,,,,,,,,,,,,,,,,,,,,,,,,,,,,,,,,,,,,,,,,,,,~~~~~",
		"1',,,,,,,,,,,,,,,,,,,,,,,,,,,,,,,,,,,,,,,,,,,,,,,,,,,,,,,,,~~~~~",
		"1',,,,,,,,,,,,,,,,,,,,,,,,,,,,,,,,,,,,,,,,,,,,,,,,,,,,,,,,,~~~~~",
		"1',,,,,,,,,,,,,,,,,,,,,,,,,,,,,,,,,,,,,,,,,,,,,,,,,,,,,,,,,~~~~~",
		"1',,,,,,,,,,,,,,,,,,,,,,,,,,,,,,,,,,,,,,,,,,,,,,,,,,,,,,,,,~~~~~",
		"1',,,,,,,,,,,,,,,,,,,,,,,,,,,,,,,,,,,,,,,,,,,,,,,,,,,,,,,,,~~~~~",
		"1',,,,,,,,,,,,,,,,,,,,,,,,,,,,,,,,,,,,,,,,,,,,,,,,,,,,,,,,,~~~~~",
		"1',,,,,,,,,,,,,,,,,,,,,,,,,,,,,,,,,,,,,,,,,,,,,,,,,,,,,,,,,~~~~~",
		"1',,,,,,,,,,,,,,,,,,,,,,,,,,,,,,,,,,,,,,,,,,,,,,,,,,,,,,,,,~~~~~",
		"1',,,,,,,,,,,,,,,,,,,,,,,,,,,,,,,,,,,,,,,,,,,,,,,,,,,,,,,,,~~~~~",
		"1',,,,,,,,,,,,,,,,,,,,,,,,,,,,,,,,,,,,,,,,,,,,,,,,,,,,,,,,,~~~~~",
		"1',,,,,,,,,,,,,,,,,,,,,,,,,,,,,,,,,,,,,,,,,,,,,,,,,,,,,,,,,~~~~~",
		"3',,,,,,,,,,,,,,,,,,,,,,,,,,,,,,,,,,,,,,,,,,,,,,,,,,,,,,,,,~~~~~",
		"3',,,,,,,,,,,,,,,,,,,,,,,,,,,,,,,,,,,,,,,,,,,,,,,,,,,,,,,,,~~~~~",
		"3',,,,,,,,,,,,,,,,,,,,,,,,,,,,,,,,,,,,,,,,,,,,,,,,,,,,,,,,,~~~~~",
		"3',,,,,,,,,,,,,,,,,,,,,,,,,,,,,,,,,,,,,,,,,,,,,,,,,,,,,,,,,~~~~~",
		"3',,,,,,,,,,,,,,,,,,,,,,,,,,,,,,,,,,,,,,,,,,,,,,,,,,,,,,,,,~~~~~",
		"3',,,,,,,,,,,,,,,,,,,,,,,,,,,,,,,,,,,,,,,,,,,,,,,,,,,,,,,,,~~~~~",
		"3',,,,,,,,,,,,,,,,,,,,,,,,,,,,,,,,,,,,,,,,,,,,,,,,,,,,,,,,,~~~~~",
		"3',,,,,,,,,,,,,,,,,,,,,,,,,,,,,,,,,,,,,,,,,,,,,,,,,,,,,,,,,~~~~~",
		"3',,,,,,,,,,,,,,,,,,,,,,,,,,,,,,,,,,,,,,,,,,,,,,,,,,,,,,,,,~~~~~",
		"3''''''''''''''''''''''''''''''',,,,,,,,,,,,,,,,,,,,,,,,,,,~~~~~",
		"3.............................'',,,,,,,,,,,,,,,,,,,,,,,,,,,~~~~~",
		"3''''''''''''''''''''''''''''''',,,,,,,,,,,,,,,,,,,,,,,,,,,~~~~~",
		"3',,,,,,,,,,,,,,,,,,,,,,,,,,,,,,,,,,,,,,,,,,,,,,,,,,,,,,,,,~~~~~",
		"3',,,,,,,,,,,,,,,,,,,,,,,,,,,,,,,,,,,,,,,,,,,,,,,,,,,,,,,,,~~~~~",
		"3',,,,,,,,,,,,,,,,,,,,,,,,,,,,,,,,,,,,,,,,,,,,,,,,,,,,,,,,,~~~~~",
		"3',,,,,,,,,,,,,,,,,,,,,,,,,,,,,,,,,,,,,,,,,,,,,,,,,,,,,,,,,~~~~~",
		"3',,,,,,,,,,,,,,,,,,,,,,,,,,,,,,,,,,,,,,,,,,,,,,,,,,,,,,,,,~~~~~",
		"3',,,,,,,,,,,,,,,,,,,,,,,,,,,,,,,,,,,,,,,,,,,,,,,,,,,,,,,,,~~~~~",
		"3',,,,,,,,,,,,,,,,,,,,,,,,,,,,,,,,,,,,,,,,,,,,,,,,,,,,,,,,,~~~~~",
		"3',,,,,,,,,,,,,,,,,,,,,,,,,,,,,,,,,,,,,,,,,,,,,,,,,,,,,,,,,~~~~~",
		"3',,,,,,,,,,,,,,,,,,,,,,,,,,,,,,,,,,,,,,,,,,,,,,,,,,,,,,,,,~~~~~",
		"3',,,,,,,,,,,,,,,,,,,,,,,,,,,,,,,,,,,,,,,,,,,,,,,,,,,,,,,,,~~~~~",
		" X,,,,,,,,,,,,,,,,,,,,,,,,,,,,,,,,,,,,,,,,,,,,,,,,,,,,,,,,,~~~~~",
		" XX,,,,,,,,,,,,,,,,,,,,,,,,,,,,,,,,,,,,,,,,,,,,,,,,,,,,,,,,~~~~~",
		"  XXX,,,,,,,,,,,,,,,,,,,,,,,,,,,,,,,,,,,,,,,,,,,,,,,,,,,,,,~~~~~",
		"    XX,,,,,,,,,,,,,,,,,,,,,,,,,,,,,,,,,,,,,,,,,,,,,,,,,,,,,~~~~~",
		"     X,,,,,,,,,,,,,,,,,,,,,,,,,,,,,,,,,,,,,,,,,,,XXXXX,,,,,~~~~~",
		"     XX,,,,,,,,,,,,,,,,,,,,,,,,,,,,,,,,,,,,,,,XXXX   XXX,,,,~~~~",
		"      XXXX,,,XXX,,,,,,,,,,,,,,,,,,,,,,,,,,,,XXX        XXXXXX~~~",
		"         XXXXX XX,,,,,,,,,,,,,,,,,,,,,,,,,,XXX              XX~~",
		"                XX,,,,,,,,,,,,,,,,,,,,,,,XXX                 X~~",
		"                 XXXXXX,,,,,,,,,,,X,,,,,XX                   XX~",
		"                      XXXX,XXXXXXXXX,XXXX                     XX",
		"                         XXX       XXX                          ",
		"                                                                "
	],
	"mapping": {
		",": ["grass", "freeland"],
		"'": ["grass"],
		"Y": ["grass", "plant"],
		"T": ["grass", "tree"],
		"~": "water",
		"=": ["water", "bridge"],
		"o": ["grass", "stone"],
		"*": ["grass", "pebble"],
		"d": ["ground", "dummy"],
		"#": "wall",
		";": ["floor", "seed"],
		".": "ground",
		"+": "floor",
		"X": "rock",
		"^": ["spiketrap", "ground"],
		"1": [{
			"type": "portal",
			"kwargs": {"destination": "begin", "destpos": "right"}
		}],
		"3": [{
			"type": "portal",
			"kwargs": {"destination": "begin", "destpos": "bottomright"}
		}],
		"%": [{
			"type": "portal",
			"kwargs": {"destination": "smallview", "destpos": "begin"}
		}, "bridge", "water"],
		"r": ["grass", "rabbit"],
		"/": ["grass", "sword"],
		"!": ["grass", "club"],
		"]": ["grass", "armour"],
		" ": []
	}
}
