{
	"width": 42,
	"height": 23,
	"spawn": [5, 15],
	"field": [
		"     XXXXXXXXXXXX~~~XXXXXXXXXXXXXXXXXXXXXX",
		"     ,,,,,,,,,,,,~~~,,,,,,,,,,,,,,,,,,,,,X",
		"    ,,,,,,,,,,,,,~~~,,,,,,,,,,,,,,,,,,,,,X",
		"    ,,,,,,,,,,,,,~~~~,,,,,,,,,,,,,,,,,,,,X",
		" bbbb..,,,,,,,,,,,~~~,,,,,,,,,,,,,,,,,,,,X",
		"    ,,.,,,,,,,,,,,~~~,,,,,,,,,,,,,,,,,,,,X",
		"   ,,,.,,,,,,,,,,,~~~,,,,,,,,,,,,,,,,,,,,X",
		"  ,,,,.,,,,,,,,,,,~~~,,,,,,,,,,,,,,,,,,,,X",
		"X,,,,,.,,,,,,,,,,,~~~~,,,,,,T,,,,,,,,,,,,X",
		"X,,,,,.,,,,,,,,,,,,~~~,,,,,,,,,,,,,,,,,,,X",
		"X,,,,,.,,,,,,,,,,,,~~~,,,,,T,,,,######,,,X",
		"X,,,,,.,,,,,,,,,,,,bbb,,,,,,,,,,#++++#,,,X",
		"X,,,,,.............bbb...........++++#,,,X",
		"X,**,,.,,,,,,,,,,,,bbb,,,,,,,,,,#++++#,,,X",
		"X,*,*,.,,,,,,,,,,,,~~~,,,T,,,T,,#++++#,,,X",
		"X,,*,,.,,,,,,,,,,,,~~~,,,,,,,,,,######,,,X",
		"X,**,,.,,,,,,,,,,,~~~~,,,,,,,,,,f,,,,f,,,X",
		"X,,*,,.,,,,,,,,,,,~~~''''''''''''''''f'''X",
		"X*,,,,.,,,,,,,,,,,~~~'''''''''''f''''f'''X",
		"X,,,,,.,,,,,,,,,,,~~~'''''''''''ffffff'''X",
		"X,,,,,.,,,,,,,,,,,~~~''''''''''''''''''''X",
		"XXXXX,.,XXXXXXXXXX~~~XXXXXXXXXXXXXXXXXXXXX",
		"     %%%                                  "
	],
	"mapping": {
		"#": "wall",
		",": "grass",
		".": "ground",
		"~": "water",
		"b": "bridge",
		"+": "floor",
		"'": "greengrass",
		"T": ["grass", "tree"],
		"f": ["grass", "fence"],
		"X": "rock",
		"*": ["grass", "pebble"],
		"%": {"type": "portal", "kwargs": {"destination": "broom"}},
		" ": []
	}
}
