{
    "width": 64,
    "height": 64,
    "spawn": [55, 37],
    "places": {
        "gate": [62, 37]
    },
    "field": [
    
        ",,,,,,,,,,,,,,,,,,,~~~~~~,,,,,,,,,,,,,,,,,,,,,,,,,,,,,,,,,,,,,,,",
        ",hhhhhhhhhhhhhhhhhh~~~~~~hhhhhhhhhhhhhhhhhhhhhhhhhhhhhhhhhhhhhh,",
        ",h,,,,,,,,,,,,,,,,,~~~~~~,,,,,,,,,,,,,,,,,,,,,,,,,,,,,,,,,,,,,h,",
        ",h,,,,,,,,,,,,,,,,,~~~~~~,,,,,,,,,,,,,,,,,,,,,,,,,,,,,,,,,,,,,h,",
        ",h,,,,,,,,,,,,,,,,,~~~~~~,,,,,,,,,,,,,,,,,,,,,,,,,,,,,,,,,,,,,h,",
        ",h,,,,,,,,,,,,,,,,,~~~~~~,,,,,,,,,,,,,,,,,,,,,,,,,,,,,,,,,,,,,h,",
        ",h,,,,,,,,,,,,,,,,,~~~~~~,,,,,,,,,,,,,,,,,,,,,,,,,,,,,,,,,,,,,h,",
        ",h,,,,,,,,,,,,,,,,,~~~~~~,,,,,,,,,,,,,,,,,,,,,,,,,,,,,,,,,,,,,h,",
        ",h,,,,,,,,,,,,,,,,,~~~~~~,,,,,,,,,,,,,,,,,,,,,,,,,,,,,,,,,,,,,h,",
        ",h,,,,,,,,,,,,,,,,,~~~~~~,,,,,,,,,,,,,,,,,,,,,,,,,,,,,,,,,,,,,h,",
        ",h,,,,,,,,,,,,,,,,,~~~~~~,,,,,,,,,,,,,,,,,,,,,,,,,,,,,,,,,,,,,h,",
        ",h,,,,,,,,,,,,,,,,,~~~~~~,,,,,,,,,,,,,,,,,,,,,,,,,,,,,,,,,,,,,h,",
        ",h,,,,,,,,,,,,,,,,,~~~~~~,,,,,,,,,,,,,,,,,,,,,,,,,,,,,,,,,,,,,h,",
        ",h,,,,,,,,,,,,,,,,,~~~~~~,,,,,,,,,,,,,,,,,,,,,,,,,,,,,,,,,,,,,h,",
        ",h,,,,,,,,,,,,,,,,,~~~~~~,,,,,,,,,,,,,,,,,,,,,,,,,,,,,,,,,,,,,h,",
        ",h,,,,,,,,,,,,,,,,,~~~~~~,,,,,,,,,,,,,,,,,,...,,,,,,,,,,,,,,,,h,",
        ",h,,,,,,,,,,,,,,,,,~~~~~~,,,,,,,,,,,,,,,,,,...,,,,,,,,,,,,,,,,h,",
        ",h,,,,,,,,,,,,,,,,,~~~~~~,,,,,,,,,,,,,,,,,,...,,,,,,,,,,,,,,,,h,",
        ",h,,,,,,,,,,,,,,,,,~~~~~~,,,,,,,,,,,,,,,,,,...,,,,,,,,,,,,,,,,h,",
        ",h,,,,,,,,,,,,,,,,,~~~~~~,,,,,,,,,,,,,,,,,,...,,,,,,,,,,,,,,,,h,",
        ",h,,,,,,,,,,,,,,,,,~~~~~~,,,,,,,,,,,,,,,,,,...,,,,,,,,,,,,,,,,h,",
        ",h,,,,,,,,,,,,,,,,,~~~~~~,,,,,,,,,,,,,,,,,,...,,,,,,,,,,,,,,,,h,",
        ",h,,,,,,,,,,,,,,,,,~~~~~~,,,,,,,,,,,,,,,,,,...,,,,,,,,,,,,,,,,h,",
        ",h,,,,,,,,,,,,,,,,,~~~~~~,,,,,,,,,,,,,,,,,,...,,,,,,,,,,,,,,,,h,",
        ",h,,,,,,,,,,,,,,,,,~~~~~~,,,,,,,,,,,,,,,,,,...,,,,,,,,,,,,,,,,h,",
        ",h,,,,,,,,,,,,,,,,,~~~~~~,,,,,,,,,,,,,,,,,,...,,,,,,,,,,,,,,,,h,",
        ",h,,,,,,,,,,,,,,,,,~~~~~~,,,,,,,,,,,,,,,,,,...,,,,,,,,,,,,,,,,h,",
        ",h,,,,,,,,,,,,,,,,,~~~~~~,,,,,,,,,,,,,,,,,,...,,,,,,,,,,,,,,,,h,",
        ",h,,,,,,,,,,,,,,,,,======.....................,,,,,,,,,,,,,,,,h,",
        ",h,,,,,,,,,,,,,,,,,======.....................,,,,,,,,,,,,,,,,h,",
        ",h,,,,,,,,,,,,,,,,,======.....................,,,,,,,,,,,,,,,,h,",
        ",h,,,,,,,,,,,,,,,,,~~~~~~,,,,,,,,,,,,,,,,,,...,,,,,,,,,,,,,,,,h,",
        ",h,,,,,,,,,,,,,,,,,~~~~~~,,,,,,,,,,,,,,,,,,...,,,,,,,,,,,,,,,,h,",
        ",h,,,,,,,,,,,,,,,,,~~~~~~,,,,,,,,,,,,,,,,,,...,,,,,,,,,,,,,,,,h,",
        ",h,,,,,,,,,,,,,,,,,~~~~~~,,,,,,,,,,,,,,,,,,...,,,,,,,,,,,,,,,,h,",
        ",h,,,,,,,,,,,,,,,,,~~~~~~,,,,,,,,,,,,,,,,,,...,,,,,,,,,,,,,,,,h%",
        ",h,,,,,,,,,,,,,,,,,~~~~~~,,,,,,,,,,,,,,,,,,....................%",
        ",h,,,,,,,,,,,,,,,,,~~~~~~,,,,,,,,,,,,,,,,,,....................%",
        ",h,,,,,,,,,,,,,,,,,~~~~~~,,,,,,,,,,,,,,,,,,....................%",
        ",h,,,,,,,,,,,,,,,,,~~~~~~,,,,,,,,,,,,,,,,,,....................%",
        ",h,,,,,,,,,,,,,,,,,~~~~~~,,,,,,,,,,,,,,,,,,...,,,,,,,,,..,,,,,h%",
        ",h,,,,,,,,,,,,,,,,,~~~~~~,,,,,,,,,,,,,,,,,,...,,,,,####++##,,,h,",
        ",h,,,,,,,,,,,,,,,,,~~~~~~,,,,,,,,,,,,,,,,,,...,,,,,#++++++#,,,h,",
        ",h,,,,,,,,,,,,,,,,,~~~~~~,,,,,,,,,,,,,,,,,,...,,,,,#++++++#,,,h,",
        ",h,,,,,,,,,,,,,,,,,~~~~~~,,,,,,,,,,,,,,,,,,...,,,,,#++++++#,,,h,",
        ",h,,,,,,,,,,,,,,,,,~~~~~~~,,,,,,,,,,,,,,,,,...,,,,,#++++++#,,,h,",
        ",h,,,,,,,,,,,,,,,,,~~~~~~~~~~~,,,,,,,,,,,,,...,,,,,#++++++#,,,h,",
        ",h,,,,,,,,,,,,,,,,,~~~~~~~~~~~~~~,,,,,,,,,,...,,,,,#++++++#,,,h,",
        ",h,,,,,,,,,,,,,,,,,~~~~~~~~~~~~~~~~~,,,,,,,...,,,,,########,,,h,",
        ",h,,,,,,,,,,,,,,,,,,~~~~~~~~~~~~~~~~~~~~~~,...,,,,,,,,,,,,,,,,h,",
        ",h,,,,,,,,,,,,,,,,,,,~~~~~~~~~~~~~~~~~~~~~~===~~~,,,,,,,,,,,,,h,",
        ",h,,,,,,,,,,,,,,,,,,,,,,~~~~~~~~~~~~~~~~~~~===~~~~~~,,,,,,,,,,h,",
        ",h,,,,,,,,,,,,,,,,,,,,,,,,~~~~~~~~~~~~~~~~~===~~~~~~~~,,,,,,,,h,",
        ",h,,,,,,,,,,,,,,,,,,,,,,,,,,,,,~~~~~~~~~~~~===~~~~~~~~~~,,,,,,h,",
        ",h,,,,,,,,,,,,,,,,,,,,,,,,,,,,,,,~~~~~~~~~~===~~~~~~~~~~~,,,,,h,",
        ",h,,,,,,,,,,,,,,,,,,,,,,,,,,,,,,,,,,,,~~~~~===~~~~~~~~~~~~,,,,h,",
        ",h,,,,,,,,,,,,,,,,,,,,,,,,,,,,,,,,,,,,,,,,,,,,,~~~~~~~~~~~,,,,h,",
        ",h,,,,,,,,,,,,,,,,,,,,,,,,,,,,,,,,,,,,,,,,,,,,,,,~~~~~~~~~~,,,h,",
        ",h,,,,,,,,,,,,,,,,,,,,,,,,,,,,,,,,,,,,,,,,,,,,,,,,,~~~~~~~~,,,h,",
        ",h,,,,,,,,,,,,,,,,,,,,,,,,,,,,,,,,,,,,,,,,,,,,,,,,,,~~~~~~~~,,h,",
        ",h,,,,,,,,,,,,,,,,,,,,,,,,,,,,,,,,,,,,,,,,,,,,,,,,,,,~~~~~~~,,h,",
        ",h,,,,,,,,,,,,,,,,,,,,,,,,,,,,,,,,,,,,,,,,,,,,,,,,,,,,~~~~~~,,h,",
        ",hhhhhhhhhhhhhhhhhhhhhhhhhhhhhhhhhhhhhhhhhhhhhhhhhhhhh~~~~~~hhh,",
        ",,,,,,,,,,,,,,,,,,,,,,,,,,,,,,,,,,,,,,,,,,,,,,,,,,,,,,~~~~~~,,,,"
    ],
    "mapping": {
        ",": "grass",
        "Y": ["grass", "plant"],
        "T": ["grass", "tree"],
        "~": "water",
        "=": ["water", "bridge"],
        "o": ["grass", "stone"],
        "*": ["grass", "pebble"],
        "d": ["ground", "dummy"],
        "#": "wall",
        "h": "fence",
        ":": ["floor", {
            "type": "spawner",
            "args": ["seed", 1, 600],
            "kwargs": {"initialSpawn": true}
        }],
        ";": ["floor", "seed"],
        ".": "ground",
        "+": "floor",
        "X": "rock",
        "^": ["spiketrap", "ground"],
        "%": [{
            "type": "portal",
            "kwargs": {"destination": "smallview", "despos": "towneast"}
        }, "ground"],
        "r": ["grass", "rabbit"],
        "/": ["grass", "sword"],
        "!": ["grass", "club"],
        "]": ["grass", "armour"],
        " ": []
    }
}
