{
    "width": 64,
    "height": 64,
    "spawn": [55, 37],
    "places": {
        "gate": [62, 37]
    },
    "field": [
    
        ",,,,,,,,,,,,,,,,,,,~~~~~~,,,,,,,,,,,,,,,,,,,,,,,,,,,,,,,,,,,,,,,",
        ",hhhhhhhhhhhhhhhhhh~~~~~~hhhhhhhhhhhhhhhhhhhhhhhhhhhhhhhhhhhhhh,",
        ",h,,,,,,,,,,,,,,,,,~~~~~~,,,,,,,,,,,,,,,,,,,,,,,,,,,,,,,,,,,,,h,",
        ",h,,,,,,,,,,,,,,,,,~~~~~~,,,,,,,,,,,,,,,,,,,,,,,,,,,,,,,,,,,,,h,",
        ",h,,,,,,,,,,,,,,,,,~~~~~~,,,,,,,,,,,,,,,,,,,,,,,,,,,,,,,,,,,,,h,",
        ",h,,,,,,,,,,,,,,,,,~~~~~~,,,,,,,,,,,,,,,,,,,,,,,,,,,,,,,,,,,,,h,",
        ",h,,,,,,,,,,,,,,,,,~~~~~~,,,,,,,,,,,,,,,,,,,,,,,,,,,,,,,,,,,,,h,",
        ",h,,,,,,,,,,,,,,,,,~~~~~~,,,,,,,,,,,,,,,,,,,,,,,,,,,,,,,,,,,,,h,",
        ",h,,,,,,,,,,,,,,,,,~~~~~~,,,,,,,,,,,,,,,,,,,,,,,,,,,,,,,,,,,,,h,",
        ",h,,,,,,,,,,,,,,,,,~~~~~~,,,,,,,,,,,,,,,,,,,,,,,,,,,,,,,,,,,,,h,",
        ",h,,,,,,,,,,,,,,,,,~~~~~~,,,,,,,,,,,,,,,,,,,,,,,,,,,,,,,,,,,,,h,",
        ",h,,,,,,,,,,,,,,,,,~~~~~~,,,,,,,,,,,,,,,,,,,,,,,,,,,,,,,,,,,,,h,",
        ",h,,,,,,,,,,,,,,,,,~~~~~~,,,,,,,,,,,,,,,,,,,,,,,,,,,,,,,,,,,,,h,",
        ",h,,,,,,,,,,,,,,,,,~~~~~~,,,,,,,,,,,,,,,,,,,,,,,,,,,,,,,,,,,,,h,",
        ",h,,,,,,,,,,,,,,,,,~~~~~~,,,,,,,,,,,,,,,,,,,,,,,,,,,,,,,,,,,,,h,",
        ",h,,,,,,,,,,,,,,,,,~~~~~~,,,,,,,,,,,,,,,,,,...,,,,,,,,,,,,,,,,h,",
        ",h,,,,,,,,,,,,,,,,,~~~~~~,,,,,,,,,,,,,,,,,,...,,,,,,,,,,,,,,,,h,",
        ",h,,,,,,,,,,,,,,,,,~~~~~~,,,,,,,,,,,,,,,,,,...,,,,,,,,,,,,,,,,h,",
        ",h,,,,,,,,,,,,,,,,,~~~~~~,,,,,,,,,,,,,,,,,,...,,,,,,,,,,,,,,,,h,",
        ",h,,,,,,,,,,,,,,,,,~~~~~~,,,,,,,,,,,,,,,,,,...,,,,,,,,,,,,,,,,h,",
        ",h,,,,,,,,,,,,,,,,,~~~~~~,,,,,,,,,,,,,,,,,,...,,,,,,,,,,,,,,,,h,",
        ",h,,,,,,,,,,,,,,,,,~~~~~~,,,,,,,,,,,,,,,,,,...,,,,,,,,,,,,,,,,h,",
        ",h,,,,,,,,,,,,,,,,,~~~~~~,,,,,,,,,,,,,,,,,,...,,,,,,,,,,,,,,,,h,",
        ",h,,,,,,,,,,,,,,,,,~~~~~~,,,,,,,,,,,,,,,,,,...,,,,,,,,,,,,,,,,h,",
        ",h,,,,,,,,,,,,,,,,,~~~~~~,,,,,,,,,,,,,,,,,,...,,,,,,,,,,,,,,,,h,",
        ",h,,,,,,,,,,,,,,,,,~~~~~~,,,,,,,,,,,,,,,,,,...,,,,,,,,,,,,,,,,h,",
        ",h,,,,,,,,,,,,,,,,,~~~~~~,,,,,,,,,,,,,,,,,,...,,,,,,,,,,,,,,,,h,",
        ",h,,,,,,,,,,,,,,,,,~~~~~~,,,,,,,,,,,,,,,,,,...,,,,,,,,,,,,,,,,h,",
        ",h,,,,,,,,,,,,,,,,,======.....................,,,,,,,,,,,,,,,,h,",
        ",h,,,,,,,,,,,,,,,,,======.....................,,,,,,,,,,,,,,,,h,",
        ",h,,,,,,,,,,,,,,,,,======.....................,,,,,,,,,,,,,,,,h,",
        ",h,,,,,,,,,,,,,,,,,~~~~~~,,,,,,,,,,,,,,,,,,...,,,,,,,,,,,,,,,,h,",
        ",h,,,,,,,,,,,,,,,,,~~~~~~,,,,,,,,,,,######,...,,,,,,,,,,,,,,,,h,",
        ",h,,,,,,,,,,,,,,,,,~~~~~~,,,,,,,,,,,#++++#,...,,,,,,,,,,,,,,,,h,",
        ",h,,,,,,,,,,,,,,,,,~~~~~~,,,,,,,,,,,#t+++#,...,,,,,,,,,,,,,,,,h,",
        ",h,,,,,,,,,,,,,,,,,~~~~~~,,,,,,,,,,,#+++++....,,,,,,,,,,,,,,,,h%",
        ",h,,,,,,,,,,,,,,,,,~~~~~~,,,,,,,,,,,#++++#,....................%",
        ",h,,,,,,,,,,,,,,,,,~~~~~~,,,,,,,,,,,######,....................%",
        ",h,,,,,,,,,,,,,,,,,~~~~~~,,,,,,,,,,,,,,,,,,....................%",
        ",h,,,,,,,,,,,,,,,,,~~~~~~,,,,,,,,,,,,,,,,,,....................%",
        ",h,,,,,,,,,,,,,,,,,~~~~~~,,,,,,,,,,,,,,,,,,...,,,,,,,,,..,,,,,h%",
        ",h,,,,,,,,,,,,,,,,,~~~~~~,,,,,,,,,,#######,...,,,,,####+###,,,h,",
        ",h,,,,,,,,,,,,,,,,,~~~~~~,,,,,,,,,,#+++++#,...,,,,,#++++++#,,,h,",
        ",h,,,,,,,,,,,,,,,,,~~~~~~,,,,,,,,,,#4++++#,...,,,,,#++++++#,,,h,",
        ",h,,,,,,,,,,,,,,,,,~~~~~~,,,,,,,,,,#++++++....,,,,,#++++++#,,,h,",
        ",h,,,,,,,,,,,,,,,,,~~~~~~~,,,,,,,,,#+++++#,...,,,,,#++++++#,,,h,",
        ",h,,,,,,,,,,,,,,,,,~~~~~~~~~~~,,,,,#+++5+#,...,,,,,#+++S++#,,,h,",
        ",h,,,,,,,,,,,,,,,,,~~~~~~~~~~~~~~,,#######,...,,,,,#++++++#,,,h,",
        ",h,,,,,,,,,,,,,,,,,~~~~~~~~~~~~~~~~~,,,,,,,...,,,,,########,,,h,",
        ",h,,,,,,,,,,,,,,,,,,~~~~~~~~~~~~~~~~~~~~~~,...,,,,,,,,,,,,,,,,h,",
        ",h,,,,,,,,,,,,,,,,,,,~~~~~~~~~~~~~~~~~~~~~~===~~~,,,,,,,,,,,,,h,",
        ",h,,,,,,,,,,,,,,,,,,,,,,~~~~~~~~~~~~~~~~~~~===~~~~~~,,,,,,,,,,h,",
        ",h,,,,,,,,,,,,,,,,,,,,,,,,~~~~~~~~~~~~~~~~~===~~~~~~~~,,,,,,,,h,",
        ",h,,,,,,,,,,,,,,,,,,,,,,,,,,,,,~~~~~~~~~~~~===~~~~~~~~~~,,,,,,h,",
        ",h,,,,,,,,,,,,,,,,,,,,,,,,,,,,,,,~~~~~~~~~~===~~~~~~~~~~~,,,,,h,",
        ",h,,,,,,,,,,,,,,,,,,,,,,,,,,,,,,,,,,,,~~~~~===~~~~~~~~~~~~,,,,h,",
        ",h,,,,,,,,,,,,,,,,,,,,,,,,,,,,,,,,,,,,,,,,,,,,,~~~~~~~~~~~,,,,h,",
        ",h,,,,,,,,,,,,,,,,,,,,,,,,,,,,,,,,,,,,,,,,,,,,,,,~~~~~~~~~~,,,h,",
        ",h,,,,,,,,,,,,,,,,,,,,,,,,,,,,,,,,,,,,,,,,,,,,,,,,,~~~~~~~~,,,h,",
        ",h,,,,,,,,,,,,,,,,,,,,,,,,,,,,,,,,,,,,,,,,,,,,,,,,,,~~~~~~~~,,h,",
        ",h,,,,,,,,,,,,,,,,,,,,,,,,,,,,,,,,,,,,,,,,,,,,,,,,,,,~~~~~~~,,h,",
        ",h,,,,,,,,,,,,,,,,,,,,,,,,,,,,,,,,,,,,,,,,,,,,,,,,,,,,~~~~~~,,h,",
        ",hhhhhhhhhhhhhhhhhhhhhhhhhhhhhhhhhhhhhhhhhhhhhhhhhhhhh~~~~~~hhh,",
        ",,,,,,,,,,,,,,,,,,,,,,,,,,,,,,,,,,,,,,,,,,,,,,,,,,,,,,~~~~~~,,,,"
    ],
    "mapping": {
        ",": "grass",
        "Y": ["grass", "plant"],
        "T": ["grass", "tree"],
        "~": "water",
        "=": ["water", "bridge"],
        "#": "wall",
        "h": "fence",
        ".": "ground",
        "+": "floor",
        "X": "rock",
        "^": ["spiketrap", "ground"],
        "%": [{
            "type": "portal",
            "kwargs": {"destination": "smallview", "destpos": "towneast"}
        }, "ground"],
        "r": ["grass", "rabbit"],
        "S": ["floor", "toolsmith"],
        "t": ["floor", "trader"],
        "4": ["floor", "loom"],
        "5": ["floor", "spinningwheel"],
        " ": []
    }
}
